000,000,000,000,000,000,000,000,000,000,000,000,000,000,000,000,000,000,000,000,
000,000,000,000,000,000,000,000,000,000,000,000,000,000,000,000,000,000,000,000,
000,000,000,000,000,000,000,000,000,000,000,000,000,000,000,000,000,000,000,000,
000,000,000,000,000,000,000,000,000,000,000,000,000,000,000,000,000,000,000,000,
001,000,000,000,000,000,000,000,000,000,000,000,000,000,000,000,000,000,000,000,
001,000,000,000,000,000,000,000,000,000,000,000,000,000,001,001,001,001,001,001,
001,000,000,000,000,000,000,000,000,000,000,000,000,000,000,000,000,000,000,000,
001,000,000,000,000,000,000,000,000,001,000,000,000,000,000,000,000,000,000,000,
001,000,000,000,000,000,000,000,001,001,000,000,000,000,000,000,000,000,000,000,
001,001,001,001,001,001,000,001,001,001,000,000,001,001,001,001,001,001,001,001,
000,000,000,000,000,000,000,000,000,000,000,000,000,000,000,000,000,000,000,000,
001,001,001,001,001,001,001,001,001,001,001,001,001,001,001,001,001,001,001,001,